SooBBBBooS
SoVVVVVVoS
SGGGGGGGGS
SRRRRRRRRS
SoVVVVVVoS
SooBBBBooS
SSSSSSSSSS
level 1
BETA
10
7
