SOOOOOOOS
SBBBBBBBS
OOOSSSOOO
SGGGGGGGS
OOOSSSOOO
SVVVVVVVS
OOOSSSOOO
SRRRRRRRS
level9.txt
Hard
: 0
no
level 9
NO ONE
9
8

