OOSSSSSOO
OBBBBBBBO
VVVVVVVVV
OOOSSSOOO
OOOSSSOOO
GSSSSSSSG
OOOSSSOOO
OOOBBBOOO
level9.txt
Normal
: 0
no
level 0
DREAM
9
8

