BOOBBBOOB
BOOBBBOOB
BBBBBBBBB
OBSSSSSBO
OBRRSRRBO
OBRRSRRBO
OBSSSSSBO
OOBBBBBOO
level7.txt
Hard
: 0
no
level 6
PLAY
9
8

