OOOOGOOOO
OOORRROOO
OOORBROOO
OOSBBBSOO
OORRRRROO
OVVVVVVVO
OVVVVVVVO
OBBOOOBBO
level2.txt
Easy
: 0
no
level 1
BEGIN
9
8
