OSOSOSOSO
OOSSSSSOO
OSBBBBBSO
OSRRBRRSO
OSRRBRRSO
OSBBBBBSO
OOSVVVSOO
OOOSSSOOO
level4.txt
Normal
: 0
no
level 3
CHILL
9
8

