SooBBBooS
SoVVVVVoS
SGGGGGGGS
SRRRRRRRS
SoVVVVVoS
SooBBBooS
BVRBVRBVR
BSVRBSVRB
level2.txt
Easy
: 1670
yes
level 1
BETA
9
8
