OOGGGGGOO
GGOSSSOGG
GGOSSSOGG
GGOVVVOGG
OOBRRRBOO
OOOVVVOOO
SSSOOOSSS
SOGSOGSOG
level8.txt
Normal
: 0
no
level 7
SELECT
9
8

