OBBBBBBBO
BOOBBBBOB
BORRRRROB
BROOBBORB
VSSSSSSSV
BSOOSOOSB
SSOOBOOSS
GGOOOOOGG
level5.txt
Normal
: 0
no
level 4
FOCUS
9
8

