SooBBBooS
SoVVVVVoS
SGGGGGGGS
SRRRRRRRS
SoVVVVVoS
SooBBBooS
SSSSSSSSS
levelsosso
BETA
9
7
score 120
