OOOBSBOOO
OOBBSBBOO
OBBBSBBBO
OBSSSSSBO
OBRBBBRBO
OBRBBBRBO
OBBBBBBBO
OGGGGGGGO
leOel6.txt
Hard
: 0
no
leOel 5
BUY
9
8

