OOOBBBOOO
OOBRBRBOO
OOOBRBOOO
BBBBGBBBB
BBOBGBOBB
BBOBGBOBB
OOOBGBOOO
OOBBOBBOO
level3.txt
Normal
: 0
yes
level 2
THE START
9
8

